11111
1PCE1
11111
10C01
11111
